ABCDEFGABC
A··PA····D
GFC·B·CD·E
F·····E··F
E·H·L·FR·G
D·IJK····A
C·····G··B
B·ABCDH·JC
A·····I··X
GFEDCBAGFE